R 1920 1080 
NO ./textures/bluestone.xpm 
SO ./textures/eagle.xpm 
WE ./textures/greystone.xpm
EA ./textures/redbrick.xpm
S ./textures/barrel.xpm
SU ./textures/greenlight.xpm
SC ./textures/pillar.xpm
F ./textures/wood.xpm
C ./textures/mossy.xpm

        1111111111111111111111111
        1000030002110000000000001
        1011000001110000002000001 
        1001000000000000000000001 
111111111011030001113002000000001 
100020000011000001110111111111111 
11110111111111211100000010041 
11110111111111011101010300001
11000000110101011100000010001 
10002000000000001120000010001 
10200000020003001101012012001 
1100004111010101111101111000111 
11110111 1110101 101111010N01
11111111 1111111 111111111111