R 1920 1080 
NO ./textures/bluestone.xpm 
SO ./textures/eagle.xpm 
WE ./textures/greystone.xpm
EA ./textures/redbrick.xpm

S ./textures/barrel.xpm
SU ./textures/greenlight.xpm
SC ./textures/pillar.xpm

F ./textures/wood.xpm
C ./textures/mossy.xpm

        1111111111111111111111111
        1040000000110000000000001
        1011000001110000002000001 
        1001003000000000000000001 
111111111011000001110000003000401 
100000003011000001110111111111111 
11110111111111011100000010031 
11110111111111011101010000001
11000000110101011100000010401 
10002000000000001100002010001 
10000000000000001101010010001 
1100000111010101111131111000111 
11110111 1110101 101111010N01
11111111 1111111 111111111111