R 700 500 
NO ./textures/bluestone.xpm 
SO ./textures/eagle.xpm 
WE ./textures/greystone.xpm
EA ./textures/redbrick.xpm
S ./textures/barrel.xpm
F 220,100,30
C 225,30,50

111111111111111111111111
100000000011000000000001
101102000111000000000001
100100020000000000000001
101100000111000000020001
10000000001100000111210011
111101111111111111000001
111101111010101011210101
110000001101010111000001
100000000000000021100001
10000000000W000011010101
110000001101010111110111
111101111111011111110111
111101111111001011000001
110000011100000011000001
100000001100000011000001
100000001111111011100011
100000001111111110010101
110000011100011010100011
100000001000001101010101
100000000000000000000001
100000001000001101010101
110000011100011010100011
100000000000000000000001
111111111111111111111111