R 640 480
NO ./textures/bluestone.xpm 
SO ./textures/eagle.xpm 
WE ./textures/greystone.xpm
EA ./textures/redbrick.xpm
S ./textures/barrel.xpm
F 00,153,15
C 255,255,255

        11111111111111111111111111111111111111
        10000000000000000000000000000000000001
        11000000000000000000000011111111111111
        1000000000000000000000001
111111111000000000000000000000001
100000000000002000000000000001111
10000000000002E20000000000001
10000000000000200000000000001
10000000000000000000000000001
10000000000000000000000000001
10000000000000200000000000001
10000000000000000000000000001
10000000000000000000000000001
10000000000000200000000000001
10000000000000000000000000001
10000000000000000000000000001
10000000000000200000000000001
10000000000000000000000000001
10000000000000000000000000001
10000000000000000001010000001
11000001110101011111011110101
11110111 1110121 101111010001
11111111 1111111 111111111111