R 1920 1080 
NO ./textures/bluestone.xpm 
SO ./textures/eagle.xpm 
WE ./textures/greystone.xpm
EA ./textures/redbrick.xpm
S ./textures/barrel.xpm
F 40,40,30
C 90,100,255

11111
10S01
10001
11211
11111